Gmy = Geometry
Pos = Position
Val = Value
Tex = Texture
Buf = Buffer
Crd = Coordinate
Rot = Rotate
Cyl = Cylinder
Bpm = Beats Per Minute
Obj = Object
Max = Maximum
Min = Minimum
Fps = Frames Per Second
Amb = Ambient
Spc = Space / Spacing
Rat = Ratio
Nte = Note
Mat = Matrix
Rad = Radians
Vib = Vibrate
Anm = Animation
Crv = Curve
Crc = Circle
Anc = Anchor
Len = Length
Fld = Folder
Mod = Model
Bnd = Bound / Bounding
Opt = Option / Options
Lgt = Light
Inst = Instrument